antigen.epitope	antigen.species	antigen.gene
KLGGALQAK	CMV	IE1
AYAQKIFKI	CMV	IE1
VTEHDTLLY	CMV	IE1
ELRRKMMYM	CMV	IE1
YILEETSVM	CMV	IE1
ELKRKMIYM	CMV	IE1
CVETMCNEY	CMV	IE1
DEEDAIAAY	CMV	IE1
VLEETSVML	CMV	IE1
LSEFCRVLCCYVLEE	CMV	IE1
QIKVRVDMV	CMV	IE1
QIKVRVKMV	CMV	IE1
NEGVKAAW	CMV	IE2
VTEHDTLLY	CMV	pp50
IPSINVHHY	CMV	pp65
QYDPVAALF	CMV	pp65
TPRVTGGGAM	CMV	pp65
RPHERNGFTVL	CMV	pp65
NLVPMVATV	CMV	pp65
CPSQEPMSIYVY	CMV	pp65
FPTKDVAL	CMV	pp65
EDVPSGKLFMHVTLG	CMV	pp65
ARNLVPMVATVQGQN	CMV	pp65
YSEHPTFTSQY	CMV	pp65
MLNIPSINV	CMV	pp65
EFFWDANDIY	CMV	pp65
RPHERNGFTV	CMV	pp65
VMAPRTLIL	CMV	UL40
GTSGSPIVNR	DENV	NS3
GTSGSPIIDK	DENV	NS3
GTSGSPIINR	DENV	NS3
GLCTLVAML	EBV	BMLF1
YVLDHLIVV	EBV	BRLF1
RAKFKQLL	EBV	BZLF1
LPEPLPQGQLTAY	EBV	BZLF1
EPLPQGQLTAY	EBV	BZLF1
GPEPLPQGQLTAY	EBV	BZLF1
LPEGLPQGQLTAY	EBV	BZLF1
LPEPLGQGQLTAY	EBV	BZLF1
LPEPLPQAQLTAY	EBV	BZLF1
LPEPLPQGGLTAY	EBV	BZLF1
LPEPLPQGQGTAY	EBV	BZLF1
LPEPLPQGQLGAY	EBV	BZLF1
LPEPLPQGQLTGY	EBV	BZLF1
HPVGEADYFEY	EBV	EBNA1
HPVGDADYFEY	EBV	EBNA1
HPVGQADYFEY	EBV	EBNA1
RLRAEAQVK	EBV	EBNA3A
FLRGRAYGL	EBV	EBNA3A
RPPIFIRRL	EBV	EBNA3A
EENLLDFVRF	EBV	EBNA3A
YPLHEQHGM	EBV	EBNA3A
IVTDFSVIK	EBV	EBNA3B
AVFDRKSDAK	EBV	EBNA3B
LLDFVRFMGV	EBV	EBNA3B
VSFIEFVGW	EBV	EBNA3B
IVTDFSVIK	EBV	EBNA4
QPRAPIRPI	EBV	EBNA6
EENLLDFVRF	EBV	EBNA6
YLLEMLWRL	EBV	LMP1
FLYALALLL	EBV	LMP2A
CLGGLLTMV	EBV	LMP2A
GAMKRHGLDNYRGYSLG	GallusGallus	LYZ
SIINFEKL	GallusGallus	OVA
GNSHRGAIEWEGIESG	GallusGallus	Ovotransferrin
HSKKKCDEL	HCV	NS3
ATDALMTGY	HCV	NS3
CINGVCWTV	HCV	NS3
KLVALGINAV	HCV	NS3
KLSALGINAV	HCV	NS3
ARMILMTHF	HCV	NS5B
SLFNTVATLY	HIV-1	Gag
RTLNAWVKV	HIV-1	Gag
SLFNTVATL	HIV-1	Gag
SLYNTVATLY	HIV-1	Gag
KAFSPEVIPMF	HIV-1	Gag
KRWIILGLNK	HIV-1	Gag
KRWIIMGLNK	HIV-1	Gag
TAFTIPSI	HIV-1	Gag
TPQDLNTML	HIV-1	Gag
EIYKRWII	HIV-1	Gag
RLRPGGKKK	HIV-1	Gag
GPGMKARVL	HIV-1	Gag
SLYNTVATL	HIV-1	Gag
CTPYDINQM	HIV-1	Gag
TLNAWVKVV	HIV-1	Gag
KINAWIKVV	HIV-1	Gag
GPGHKARVL	HIV-1	Gag
GLNKIVRMY	HIV-1	Gag
QASQEVKNW	HIV-1	Gag
FLGKIWPSHK	HIV-1	Gag
RLRPGGKKR	HIV-1	Gag
RLRPGGRKR	HIV-1	Gag
GEIYKRWII	HIV-1	Gag
ISPRTLNAW	HIV-1	Gag
FRDYVDRFYKTLRAEQASQE	HIV-1	Gag
DRFYKTLRAEQASQEV	HIV-1	Gag
LNKIVRMYSPTSILD	HIV-1	Gag
RFPLTFGWCF	HIV-1	Nef
RYPLTFGWCF	HIV-1	Nef
RYPLTLGWCF	HIV-1	Nef
FLKEKGGL	HIV-1	Nef
FLKEQGGL	HIV-1	Nef
FLKETGGL	HIV-1	Nef
FLKEMGGL	HIV-1	Nef
QVPLRPMTYK	HIV-1	Nef
TQGYFPDWQNY	HIV-1	Nef
TPGPGVRYPL	HIV-1	Nef
ILKEPVHGV	HIV-1	Pol
ISPRTLNAW	HIV-1	Pol
FPQGEAREL	HIV-1	Pol
TAFTIPSI	HIV-1	Pol
IIKDYGKQM	HIV-1	Pol
LPPIVAKEI	HIV-1	Pol
HPKVSSEVHI	HIV-1	Vif
FPRPWLHGL	HIV-1	Vpr
EEYLQAFTY	HomoSapiens	ABCD3
KLMNIQQKL	HomoSapiens	AKAP13
RIAAWMATY	HomoSapiens	BCL2L1
YLNDHLEPWI	HomoSapiens	BCL2L1
LLLGIGILV	HomoSapiens	BST2
LGYGFVNYI	HomoSapiens	ELAVL4
KIFGSLAFL	HomoSapiens	ERBB2
IILVAVPHV	HomoSapiens	EXOC8
NLSALGIFST	HomoSapiens	IGF2BP2
ALWGPDPAAA	HomoSapiens	INS
QPLALEGSLQKRG	HomoSapiens	INS
LQPLALEGSLQKRG	HomoSapiens	INS
KLQCVDLHV	HomoSapiens	KLK3
KVLEYVIKV	HomoSapiens	MAGEA1
KVAELVHFL	HomoSapiens	MAGEA3
VHFFKNIVTPRTPG	HomoSapiens	MBP
PADPLAFFSSAIKGGGGSLV	HomoSapiens	MCC
ADGLAYFRSSFKGG	HomoSapiens	MCC
ANGVAFFLTPFKA	HomoSapiens	MCC
ELAGIGILTV	HomoSapiens	MLANA
EEYLKAWTF	HomoSapiens	MLANA
AAGIGILTV	HomoSapiens	MLANA
ALGIGILTV	HomoSapiens	MLANA
ELAAIGILTV	HomoSapiens	MLANA
ELAGIGALTV	HomoSapiens	MLANA
EAAGIGILTV	HomoSapiens	MLANA
ELAGIGLTV	HomoSapiens	MLANA
EEAAGIGIL	HomoSapiens	MLANA
CLNEYHLFL	HomoSapiens	NDC1
SLLMWITQV	HomoSapiens	NY-ESO-1
SLLMWITQC	HomoSapiens	NY-ESO-1
MLGEQLFPL	HomoSapiens	PABPC1
FLASKIGRLV	HomoSapiens	PLA2G6
IMDQVPFSV	HomoSapiens	PMEL
KTWGQYWQV	HomoSapiens	PMEL
FLYNLLTRV	HomoSapiens	SEC24A
VAANIVLTV	HomoSapiens	SLC30A8
ILAKFLHWL	HomoSapiens	TERT
AMFWSVPTV	HomoSapiens	TKT
GELIGILNAAKVPAD	HomoSapiens	TPI1
GELIGTLNAAKVPAD	HomoSapiens	TPI1
CLLWSFQTSA	HomoSapiens	TYR
CYTWNQMNL	HomoSapiens	WT1
RMFPNAPYL	HomoSapiens	WT1
MLDLQPETT	HPV	E7
RPRGEVRFL	HSV-2	UL49
LLFGYPVYV	HTLV-1	Tax
LLFGYAVYV	HTLV-1	Tax
LLFGYPRYV	HTLV-1	Tax
LLFGYPVAV	HTLV-1	Tax
LLFGKPVYV	HTLV-1	Tax
LLFGPVYV	HTLV-1	Tax
LLFGFPVYV	HTLV-1	Tax
SFHSLHLLF	HTLV-1	Tax
PKYVKQNTLKLAT	InfluenzaA	HA
PKYVKQNTLKLRT	InfluenzaA	HA
PKYVKQNTLKLAR	InfluenzaA	HA
GILGFVFTL	InfluenzaA	M
CTELKLSDY	InfluenzaA	NP
LPRRSGAAGA	InfluenzaA	NP
ASNENMETM	InfluenzaA	NP
SSLENFRAYV	InfluenzaA	PA
LSLRNPILV	InfluenzaA	PB1
SSYRRPVGI	InfluenzaA	PB1
CVNGSCFTV	InfluenzaA	NA
KAVYNFATC	LCMV	GPC
ADLIAYLKQATKG	ManducaSexta	MCC
TVYGFCLL	MCMV	m139
SSPPMFRV	MCMV	M38
HGIRNASFI	MCMV	M45
KVITFIDL	MusMusculus	Gtpbp1
INFDFNTI	MusMusculus	Kctd20
SRGGASQYRPSQ	MusMusculus	Mbp
RGGASQYRPSQ	MusMusculus	Mbp
EQYKFYSV	MusMusculus	Ndufa4
SQYYYNSL	MusMusculus	Rbm5
SQLLNAKYL	PlasmodiumBerghei	GAP50
NAITNAKII	RSV	M
SYIGSINNI	RSV	M2-1
MLWGYLQYV	SaccharomycesCerevisiae	Tel1
CTPYDINQM	SIV	Gag
TTPESANL	SIV	Tat
STPESANL	SIV	Tat
CLLGTYTQDV	StreptomycesKanamyceticus	KanJ
SIYRYYGL	Synthetic	Synthetic
WIYVYRPMGCGGS	Synthetic	Synthetic
SGEGSFQPSQENP	TriticumAestivum	NA
APQPELPYPQPGS	TriticumAestivum	NA
APQPELPYPQPG	TriticumAestivum	NA
QPFPQPELPYP	TriticumAestivum	NA
PSGEGSFQPSQENPQ	TriticumAestivum	NA
RGYVYQGL	VSV	N
RGYVYKGL	VSV	N
RGYVYEGL	VSV	N
RGYVYDGL	VSV	N
IGYVYQGL	VSV	N
KGYVYQGL	VSV	N
LLWNGPMAV	YFV	NS4B
